動詞接尾辞	pestrenoleu fua ftona
異形態	etol io
派生関係	staliulo	「関連語」と訳出
子音幹名詞	ftlexest pervoj	「子音終わりの名詞」と訳出
母音幹名詞	ftlexest fendej	「母音終わりの名詞」と訳出
状態動詞	sytenen ftona
ラネーメ祖語形	lanerme fevan'jexao io	
同根語	daliu farteven
母音幹接尾辞	pestrenoleu fua ftlexest fendej
子音幹接尾辞	pestrenoleu fua ftlexest pervoj
単複	fanklavolo/eustira
動作動詞	jonusten ftona
受動	krackrama'd
受動専用	krackram lap
後置詞	kafnisfamsk
連体詞	kraftan
副詞	ftonaol
瞬間動詞	narlen ftona
人名を作る	pestrenoleu fua laoziavo phertarsen ferlk
間投詞	krackrafi'a